TitleLine1	********************************************************************************
TitleLine2	*                    Projet Informatique : étude des prénoms                   *
TitleLine3	********************************************************************************
MenuLine1	Menu :
MenuChoice1	1) Affichage d'un prénom quelconque sur une année
MenuChoice2	2) Top 10 des prénoms sur une période donnée
MenuChoice3	3) Nombre de naissance et rang d'un prénom sur une période donnée
MenuChoice4	4) Tendance d'un prénom au hasard sur les X dernières années
MenuChoice0	0) Quitter le programme
EnterChoice	Veuillez entrer votre choix
IncorrectValue	Valeur Incorrecte
ReturnToMenu	Appuyer sur entrée pour retourner au menu
EnterYear	Veuillez entrer une année :
IncorrectYear	Année incorrecte
EnterFirstName	Veuillez entrer le prénom à étudier.
NameData	Données concernant le prénom {0} durant l'année {1}
NumberData	Ce prénom a été donné {0} fois sur cette année.
OrderData	Ordre du prénom (sur 100) sur cette année : {0}
Top10Res	{0} : {1} (Nombre de prénom sur la période : {2})
NumPeriode	Le prénom {0} a été donné {1} fois sur cette période
OrderName	Ce nom occupe la {0}ème sur un total de {1}
periodeTrend	Veuillez entrer le nombre d'années sur lesquelles vous voulez étudier la tendance :
Trend	Voyons la tendance du prénom {0} sur les {1} dernières années
Abandonement	Ce prénom est à l'abandon depuis les {0}  dernières années
Outmoded	Ce prénom est désuet depuis les {0}  dernières années
Hold	Ce prénom se maintient depuis les {0}  dernières années
Fashionable	Ce prénom est en vogue depuis les {0}  dernières années
Explosed	Ce prénom explose depuis les {0}  dernières années
ChoiceName	Voulez-vous choisir les prénoms à étudier ? Entrez y pour pouvoir les choisir, et n si vous souhaitez qu'ils soient choisis aléatoirement.
WrongEntry	Valeur incorrecte.